1111111111
0110000001
1000000110
1111111111